+..+.........+
WWW.WWWWWWWWWW
WWW+WWWWWWWWWW
WWW.WWWWWWWWWW
+..+WWWWWWWWWW
