W W W W W W W W W W W W W W W W W W W W W W W W W W W W
W W W W W W W W W W W W W W W W W W W W W W W W W W W W
W C c c c c C c c c c c C W W C c c c c c C c c c c C W
W c W W W W c W W W W W c W W c W W W W W c W W W W c W
W c W W W W c W W W W W c W W c W W W W W c W W W W c W
W c W W W W c W W W W W c W W c W W W W W c W W W W c W
W C c c c c C c c C c c C c c C c c C c c C c c c c C W
W c W W W W c W W c W W W W W W W W c W W c W W W W c W
W c W W W W c W W c W W W W W W W W c W W c W W W W c W
W C c c c c C W W C c c C W W C c c C W W C c c c c C W
W W W W W W c W W W W W c W W c W W W W W c W W W W W W
W W W W W W c W W W W W c W W c W W W W W c W W W W W W
W W W W W W c W W C c c C c G C c c C W W c W W W W W W
W W W W W W c W W c W W W c c W W W c W W c W W W W W W
W W W W W W c W W c W W W W W W W W c W W c W W W W W W
W c c c c W C c c C W W W W W W W W C c c C W c c c c W
W W W W W W c W W c W W W W W W W W c W W c W W W W W W
W W W W W W c W W c W W W W W W W W c W W c W W W W W W
W W W W W W c W W C c c c c c c c c C W W c W W W W W W
W W W W W W c W W c W W W W W W W W c W W c W W W W W W
W W W W W W c W W c W W W W W W W W c W W c W W W W W W
W C c c c c C c c C c c C W W C c c C c c C c c c c C W
W c W W W W c W W W W W c W W c W W W W W c W W W W c W
W c W W W W c W W W W W c W W c W W W W W c W W W W c W
W C c C W W C c c C c c C c c C c c C c c C W W C c C W
W W W c W W c W W c W W W W W W W W c W W c W W c W W W
W W W c W W c W W c W W W W W W W W c W W c W W c W W W
W C c C c c C W W C c c C W W C c c C W W C c c C c C W
W c W W W W W W W W W W c W W c W W W W W W W W W W c W
W c W W W W W W W W W W c W W c W W W W W W W W W W c W
W C c c c c c c c c c c S c c C c c c c c c c c c c C W
W W W W W W W W W W W W W W W W W W W W W W W W W W W W
W W W W W W W W W W W W W W W W W W W W W W W W W W W W