W W W W W W W W W W W W W W W W W W W W
W F c c C W C c c c c c c C W C c c F W
W c W W c W c W W W W W W c W c W W c W
W c W C C c C c c C C c c C c C C W c W
W c W c W W c W W . . W W c W W c W c W
1 C c C c c C W G G G G W C c c C c C 1
W c W c W W c W W W W W W c W W c W c W
W c W C C c C c c c c c c C c C C W c W
W c W W c W c W W W W W W c W c W W c W
W F c c C W C c c S c c c C W C c c F W
W W W W W W W W W W W W W W W W W W W W