+...........+
...X..XXXXXX.
...+..XXXXXX.
......XXXXXX.
......XXXXXX.
+...........+
