+..+.+XXXX
...X..XXXX
...+..XXXX
......XXXX
......XXXX
+..+.+XXXX
