1ccCc...S.c..1
WWW.WWWWWWWWWW
WWWcWWWWWWWWWW
WWWcWWWWWWWWWW
...+WWWWWWWWWW