+..+.....G...+
WWW.WWWWWWWWWW
WWW+WWWWWWWWWW
WWW.WWWWWWWWWW
S..+WWWWWWWWWW