1..+.......S.1
WWW.WWWWWWWWWW
WWW.WWWWWWWWWW
WWW.WWWWWWWWWW
...+WWWWWWWWWW