1.......S..G.1
WWW.WWWWWWWWWW
WWW.WWWWWWWWWW
WWW.WWWWWWWWWW
...+WWWWWWWWWW